6 8
.$......
.####.#.
#...#.##
....#.#.
...#..X.
........